┌─────┬─────────────┐
│     │             │
├───│ │ │─┬───┬───│ │
│     │   │   │     │
│ ┌───┘ │ │ │─┘ ┌───┤
│ │     │ │     │   │
│ └───┐ │ └─┐ ┌─┴─┐ │
│     │ │   │ │   │ │
├───│ └─┴─│ │ │ │ │ │
│           │   │   │
└───────────┴───┴───┘
